10
1111111111
1001100031
1001100001
1100000001
1000000001
1101000001
1101000001
1001000001
1111100001
1111111111
